Starter
**********
*        *
*   V    *
*        *
*   O    *
*        *
*        *
*   X    *
*        *
**********

%%

Two boxes
@@@@@
@^O @
@O X@
@ X @
@@@@@

%%

Ride around
@@@@@@@@@@
@>O      @
**** *** @
@        @
@@@@@@@@X@
