Starter
**********
*        *
*   V    *
*        *
*   O    *
*        *
*        *
*   X    *
*        *
**********

%%

Ride around
************
*          *
* >O   O   *
***** ***  *
*          *
*    X   X *
************

%%
